Monsters: 20
RRRRRRRRRRRRRRRRRRRRRRRRRRRRRRRRRRRRRRRRRRRRRRRRRRRRRRRRRRRRRRRRRRRRRRRRRRRRRRRRRRRRRRRRRRRRRRRRRRRRRRRRRRRRRRRRRRRRRRRRRRRRRRRRRRRRRRRRRRRRRRRRRRRRRRRRRRRRRRRRRRRRRRRRRRRRRRRRRRRRRRRRRRRRRRRRRRRRRRRRRRRRRRRRRRRRRRRRRRRRRRRR
RRRRRRRRRRRRRRRRRRRRRRRRRRRRRRRRRRRRRRRRRRRRRRRRRRRRRRRRRRRRRRRRRRRRRRRRRRRRRRRRRRRRRRRRRRRRRRRRRRRRRRRRRRRRRRRRRRRRRRRRRRRRRRRRRRRRRRRRRRRRRRRRRRRRRRRRRRRRRRRRRRRRRRRRRRRRRRRRRRRRRRRRRRRRRRRRRRRRRRRRRRRRRRRRRRRRRRRRRRRRRRRR
RR..........RR................................................................................................................................................................................................................RR
RR....@.....RR................................................................................................................................................................................................................RR
RR..........RR................................................................................................................................................................................................................RR
RR..RRRRRRRRRR................................................................................................................................................................................................................RR
RR..RRRRRRRRRR................................................................................................................................................................................................................RR
RR......................RR..............RR..........GG....................LL..................................LL........BB................BB........LL................BBBBBBGGBBBBGGBBBBGGBBBB..BBBBGGBBBBGGBBBBGGBBBBBB......RR
RR......................RR..............RR..........GG....................LL..................................LL........BB................BB........LL................BBBBBBGGBBBBGGBBBBGGBBBB..BBBBGGBBBBGGBBBBGGBBBBBB......RR
RR......................RR..............LL..........LL........................................................GG........BB................BB........GG................BB............BB..................BB............BB......RR
RR......................RR..............LL..........LL........................................................GG........BB................BB........GG................BB............BB..................BB............BB......RR
RR......................RR................................................LL..................................BB........BB................BB........BB................BBBBBBBBBBBB..........................BBBBBBBBBBBB......RR
RR......................RR................................................LL..................................BB........BB................BB........BB................BBBBBBBBBBBB..........................BBBBBBBBBBBB......RR
RR......................RR..............LL..........LL..........RRRRRRRRRRRR............................................BB................BB..........................LL..............................................LL......RR
RR......................RR..............LL..........LL..........RRRRRRRRRRRR............................................BB................BB..........................LL..............................................LL......RR
RR......................RRRRRRGGRRGGRRRRRR..........GG....................RR..................................BR........BBBBBBLL....LLBBBBBB........BB........................................................................RR
RR......................RRRRRRGGRRGGRRRRRR..........GG....................RR..................................BR........BBBBBBLL....LLBBBBBB........BB........................................................................RR
RR..................................................RRRRRRRRRRGGGGRRRRRRRRRR..................................GG....................................GG........................................................................RR
RR..................................................RRRRRRRRRRGGGGRRRRRRRRRR..................................GG....................................GG........................................................................RR
RR............................................................................................................LL....................................LL................LL..............................................LL......RR
RR............................................................................................................LL....................................LL................LL..............................................LL......RR
RR............................................................................................................LLGGGGLLBBBBBBBBLL....LLBBBBBBBBLLGGGGLL................BB..............................................BB......RR
RR............................................................................................................LLGGGGLLBBBBBBBBLL....LLBBBBBBBBLLGGGGLL................BB..............................................BB......RR
RR....................................................................................................................................................................BB..............................................BB......RR
RR....................................................................................................................................................................BB..............................................BB......RR
RR....................................................................................................................................................................BBBBBBGGBBBBGGBBBBGGBBBB..BBBBGGBBBBGGBBBBGGBBBBBB......RR
RR....................................................................................................................................................................BBBBBBGGBBBBGGBBBBGGBBBB..BBBBGGBBBBGGBBBBGGBBBBBB......RR
RR............................................................................................................................................................................................................................RR
RR............................................................................................................................................................................................................................RR
RR................................................................................................................................BBBBGGGGBBLL....LLBBGGGGBBBB................................................................RR
RR................................................................................................................................BBBBGGGGBBLL....LLBBGGGGBBBB................................................................RR
RR....................LLLLLLLLLLGGGGGGLLLLLLLLLLLLLLLLLLLLLLLLGGGGGGLLLLLLLLLL............BBGGBBBBGGBB............................BB........................BB................................................................RR
RR....................LLLLLLLLLLGGGGGGLLLLLLLLLLLLLLLLLLLLLLLLGGGGGGLLLLLLLLLL............BBGGBBBBGGBB............................BB........................BB................................................................RR
RR....................LL..........................LL........................LL............BB........BB............................BB........................BB................................................................RR
RR....................LL..........................LL........................LL............BB........BB............................BB........................BB................................................................RR
RR....................GG..........................LL........................GG............BB........GG............................LL........................LL................................................................RR
RR....................GG..........................LL........................GG............BB........GG............................LL........................LL................................................................RR
RR....................LLLLLLLLLLLLLL..LLLLLLLLLLLLLLLLLLLLLLLLLL..LLLLLLLLLLLL......................GG........................................................................................................................RR
RR....................LLLLLLLLLLLLLL..LLLLLLLLLLLLLLLLLLLLLLLLLL..LLLLLLLLLLLL......................GG........................................................................................................................RR
RR........................................................................................BB........BB............................LL........................LL................................................................RR
RR........................................................................................BB........BB............................LL........................LL................................................................RR
RR........................................................................................BBGGBBBBGGBB............................BB........................BB................................................................RR
RR........................................................................................BBGGBBBBGGBB............................BB........................BB................................................................RR
RR....................LLLLLLLL..LLLLLLLLLLLLLLLLLL..LLLLLLLLLLLLLLLL..LLLLLLLL....................................................BB........................BB........................LLLLBB..BBLLLL..........................RR
RR....................LLLLLLLL..LLLLLLLLLLLLLLLLLL..LLLLLLLLLLLLLLLL..LLLLLLLL....................................................BB........................BB........................LLLLBB..BBLLLL..........................RR
RR....................GG..............LL....................LL..............GG....................................................BBBBGGGGBBLL....LLBBGGGGBBBB........................BB..........BB..........................RR
RR....................GG..............LL....................LL..............GG....................................................BBBBGGGGBBLL....LLBBGGGGBBBB........................BB..........BB..........................RR
RR....................LL..............LL....................LL..............LL....................................................................................................................BB..........................RR
RR....................LL..............LL....................LL..............LL....................................................................................................................BB..........................RR
RR....................LLLLLLLL..LLLLLLLLLLLLLLLLLL..LLLLLLLLLLLLLLLL..LLLLLLLL............RRRRRR..RRRRRR..............................................................................BB......................................RR
RR....................LLLLLLLL..LLLLLLLLLLLLLLLLLL..LLLLLLLLLLLLLLLL..LLLLLLLL............RRRRRR..RRRRRR..............................................................................BB......................................RR
RR........................................................................................RR..........RR..............................................................................BB..........BB..........................RR
RR........................................................................................RR..........RR..............................................................................BB..........BB..........................RR
RR....................................................................................................................................................................................LLLLGGGGGGLLLL..........................RR
RR....................................................................................................................................................................................LLLLGGGGGGLLLL..........................RR
RR........................................................................................RR..........RR.....................................................................................................................#RR
RRRRRRRRRRRRRRRRRRRRRRRRRRRRRRRRRRRRRRRRRRRRRRRRRRRRRRRRRRRRRRRRRRRRRRRRRRRRRRRRRRRRRRRRRRRRRRRRRRRRRRRRRRRRRRRRRRRRRRRRRRRRRRRRRRRRRRRRRRRRRRRRRRRRRRRRRRRRRRRRRRRRRRRRRRRRRRRRRRRRRRRRRRRRRRRRRRRRRRRRRRRRRRRRRRRRRRRRRRRRRRRR
RRRRRRRRRRRRRRRRRRRRRRRRRRRRRRRRRRRRRRRRRRRRRRRRRRRRRRRRRRRRRRRRRRRRRRRRRRRRRRRRRRRRRRRRRRRRRRRRRRRRRRRRRRRRRRRRRRRRRRRRRRRRRRRRRRRRRRRRRRRRRRRRRRRRRRRRRRRRRRRRRRRRRRRRRRRRRRRRRRRRRRRRRRRRRRRRRRRRRRRRRRRRRRRRRRRRRRRRRRRRRRRR
